ADCY2bspf	AGGTTTTTAAGGTGATAGGGAGG
ADCY2bspt	AAATTAAAAACTCCCCCATCCT
ADCY2mf	GGAGTTATTTTTAGGGTCGATTC
ADCY2mt	CCGTAACTAATCGTAATCCTCG
ADCY2uf	GGGAGTTATTTTTAGGGTTGATTT
ADCY2ut	CCCCATAACTAATCATAATCCTCA
CALCAbspf	GGAGGGAGAGATATATATTTGAGT
CALCAbspt	AACCCAAAAACAAAAAACC
CALCAmf	TTCGGGGTTTATTTGGC
CALCAmt	ACACTAACGAAACTTTCCCG
CALCAuf	GATTTTGGGGTTTATTTGGT
CALCAut	ACTATACACTAACAAAACTTTCCCA
CALCA2bspf	TTTTTTTAGGGGGTTGGT
CALCA2bspt	AAACTCATTATACCCAAAATCC
CALCA2mf	TGGGTATTTAAGATTCGTTTTTC
CALCA2mt	ACTTACCTATTTCACGCTCTACG
CALCA2uf	GGGTATTTAAGATTTGTTTTTTG
CALCA2ut	CAACTTACCTATTTCACACTCTACA
CD26bspf	GGGGTTGTTTTAGAGGTAGTAGGA
CD26bspt	CCAAAACCACCCTCTAACAAATA
CD26mf	TTTTTTTATTTTTGTTCGGGTTC
CD26mt	AAAACGTCCCAAAACTCTCG
CD26uf	TTTTTTATTTTTGTTTGGGTTT
CD26ut	AAAACATCCCAAAACTCTCA
CDH1bspf	TTTTTTTGGTTTTGTTAGGAGT
CDH1bspt	CAAACAAAATTACCCCCTC
CDH1mf	TTATTTGGAGAGAGGTCGC
CDH1mt	ACGTAAATTCCAAAAAATATCG
CDH1uf	GTTATTTGGAGAGAGGTTGT
CDH1ut	ACATAAATTCCAAAAAATATCA
CDKN2Abspf	TGGGGTTTTTTATGTAGTTGA
CDKN2Abspt	CCCAAACTAAAATTCCAAAA
CDKN2Amf	TTTAGTACGGGATGAGGTAGC
CDKN2Amt	CAAACCGAAAAAAACTCTACG
CDKN2Auf	TTTTAGTATGGGATGAGGTAGT
CDKN2Aut	CAAACCAAAAAAAACTCTACA
CLEC14Abspf	GAGTTGTTTTTAATTTGGATTTGTT
CLEC14Abspt	CAACTATATTCCTAACCCCAAAATA
CLEC14Amf	GATTTGTTTCGTTCGAGGAC
CLEC14Amt	AACTATTAACCGCTAAACCCG
CLEC14Auf	GGATTTGTTTTGTTTGAGGAT
CLEC14Aut	AAAAACTATTAACCACTAAACCCA
CTNNB1bspf	GATTTAGGTTTAGTAGGGAGTGTG
CTNNB1bspt	ACCCTAATATCCTCCCCTATC
CTNNB1mf	GTCGGGAATTCGTAGATTAGC
CTNNB1mt	GAAAATTCGAAACCAAAACG
CTNNB1uf	GGTTGGGAATTTGTAGATTAGT
CTNNB1ut	CAAAAATTCAAAACCAAAACA
DAPK1bspf	TTTTTTATTTATTTTTTAGTTGTG
DAPK1bspt	CTTAACCTTCCCAATTACTC
DAPK1mf	GGGATTCGGTAATTCGTAGC
DAPK1mt	CGAAAACCGACCATAAACG
DAPK1uf	GGGGATTTGGTAATTTGTAGT
DAPK1ut	ATCAAAAACCAACCATAAACA
ESR1bspf	AGTTAATGTTAGGGTAAGGTAATA
ESR1bspt	AAACAAAAAACTCAAAAACC
ESR1mf	CGGGAGTTTAGGAGTTGGC
ESR1mt	GAAATTAAAAACGACGCAACG
ESR1uf	TTGGGAGTTTAGGAGTTGGT
ESR1ut	CCAAAATTAAAAACAACACAACA
ESR2bspf	GGTTTTGTTTTTTTTAAAATG
ESR2bspt	TTTTCAATTTCTCCAACTACTA
ESR2mf	TGTTTTTTTTAAAATGCGGATAC
ESR2mt	AAAAACCACCCGAACTACG
ESR2uf	TTGTTTTTTTTAAAATGTGGATAT
ESR2ut	AAAAAACCACCCAAACTACA
FOXE11bspf	GTAAGGATTTGGGTTTTGTTT
FOXE11bspt	AATTCCAATAACTCCAACCC
FOXE11mf	TTTTCGAAGGTAGTTGTTTAAC
FOXE11mt	CGAAAATTCTAACCAATAACG
FOXE11uf	TTTTTGAAGGTAGTTGTTTAAT
FOXE11ut	CAAAAATTCTAACCAATAACA
FOXE12bspf	TTTTTTAAGGAGGGGAAGT
FOXE12bspt	TCCCTAAATTAAAATAACTACAACT
FOXE12mf	TTCGTAGGGTTGGAGATTTAC
FOXE12mt	GAACTCGAAAACCAAAACG
FOXE12uf	TTTGTAGGGTTGGAGATTTAT
FOXE12ut	CAAACTCAAAAACCAAAACA
GATA4bspf	GGGTTTAGGGATTGAATGTTTTT
GATA4bspt	CCCTCCTTTCCTCAACCTAATAA
GATA4mf	ATTGGTTAAGGGTTCGAGTTC
GATA4mt	CAACCTAATAACAATCCGCG
GATA4uf	GAAATTGGTTAAGGGTTTGAGTTT
GATA4ut	CCTCAACCTAATAACAATCCACA
GREM1bspf	TTTTGAGGATTAGGGATTGG
GREM1bspt	AACTAAAACACCCCCAAAAA
GREM2bspf	ATTTGGGTTGAAAGAATTTTTG
GREM2bspt	CCCAAATCTAAACTTTCCCTATC
GREM2mf	TAGCGAGTTCGTTAGGTTAACG
GREM2mt	AACGAAATCTCCGTAAAATCGT
GREM2uf	GGTTAGTGAGTTTGTTAGGTTAATG
GREM2ut	AAAAACAAAATCTCCATAAAATCAT
GSTP1bspf	AAAGAGGGAAAGGTTTTTT
GSTP1bspt	CTAAAAACTCTAAACCCCATC
GSTP1mf	TTTTTCGGTTAGTTGCGC
GSTP1mt	GCCCCAATACTAAATCACGA
GSTP1uf	AAAGGTTTTTTTGGTTAGTTGTGT
GSTP1ut	CCACCCCAATACTAAATCACA
GSTP1Bbspf	TTTAGAATTTTAAATAAAAGTTGG
GSTP1Bbspt	AACCCAAACTAAAATACAATAAC
GSTP1Bmf	GTTAGGCGTGGTGGTTTAC
GSTP1Bmt	ATACAATAACGCGATCTCGA
GSTP1Buf	TTAGGTGTGGTGGTTTATG
GSTP1But	AAAATACAATAACACAATCTCAA
HOXB2bspf	ATGGAGGGGGTAAGGAATTTTA
HOXB2bspt	CAAAAACCCAAAAACCAAAAAC
HOXB2mf	GATTTGTAGGCGATTCGATTTC
HOXB2mt	ATAAACCTACTCTACCGCCGC
HOXB2uf	TTTGTAGGTGATTTGATTTTG
HOXB2ut	AAATAAACCTACTCTACCACCAC
MGMTbspf	TTTTTGTGATAGGAAAAGGTA
MGMTbspt	AACCTAAAAAAAACAAAAAAAC
MGMTmf	TATCGGTCGAAGGGTTATTC
MGMTmt	AAACAATCTACGCATCCTCG
MGMTuf	TTGTATTGGTTGAAGGGTTATTT
MGMTut	CCTAAAACAATCTACACATCCTCA
NEUROG1bspf	GGGTTAAGTTGGTTAGGG
NEUROG1bspt	CCTCCACAAAATAAACTTTTAT
NEUROG1mf	CGTTTTTAGGTAGTGAAATAGAGGC
VWCEbspfÂ 	GGGGTAAAGATTAGGGATTTT
VWCEbspt	AAACCTTCTAACAAACTAAAAACAA
